[GRID]
grid_size=10
cell_size=50

[TILES]
e2 v0 v0 v2 e0 v0 v0 e0 v0 e0
v0 v0 v0 t0 e0 e0 t0 v0 t0 e0
e0 v0 e0 t0 l0 e0 t0 e0 l0 e0
e0 t0 l0 t0 l0 v0 t0 t0 v0 t0
e0 t0 v0 v0 t0 t0 e0 v0 e0 t0
v0 v0 t0 l0 l0 t0 t0 t0 t0 v0
l1 e1 t1 v0 v0 v0 v0 l0 v0 e0
l1 v0 t0 t0 e0 l0 e0 t0 l0 v0
e0 t0 e0 t0 e0 l0 t0 t0 e0 e0
e0 t0 e0 v0 e0 e0 e0 v0 t0 e0

[SOURCE]
5 5