[GRID]
grid_size=7
cell_size=70

[TILES]
e0 e0 e0 t0 t0 e0 e0
t0 t0 t0 t0 v0 e0 l0
l0 e0 t0 t0 t0 t0 v0
e0 e0 v0 l0 e0 t0 e0
v0 t0 t0 t0 v0 e0 e0
l0 l0 v0 v0 t0 t0 t0
e0 v0 e0 e0 e0 e0 e0

[SOURCE]
3 3